14 14 14 14 14 14 14 14 14 14 14 14 14 14 14 14 14 14 14 14 14 14 14 14 14 14 14 14 14 14 14 14 14 14 14 14 14 14 14 14 14 14 14 14 14 14 14 14 14 14
14 14 14 14 14 14 14 14 14 14 14 14 19 17 17 17 17 17 17 17 17 17 17 17 17 17 17 17 17 17 20 14 14 14 14 14 14 14 14 14 14 14 14 14 14 14 14 14 14 14
14 14 14 14 14 19 17 17 17 17 17 17 18 23 23 23 23 23 23 45 45 45 45 45 23 23 23 23 23 23 16 17 17 17 17 17 17 17 20 14 14 14 14 14 14 14 14 14 14 14
14 14 14 19 17 18 23 23 23 23 23 23 23 23 23 10 11 12 24 45 26 26 26 45 23 23 23 23 23 23 23 23 23 23 23 23 23 23 16 20 14 14 14 14 14 14 14 14 14 14
14 14 19 18 23 23 23 23 23 23 23 23 23 23 23 16 17 18 24 45 26 26 26 26 23 24 24 24 24 24 24 24 24 24 24 24 24 24 24 13 14 14 14 14 14 14 14 14 14 14
14 14 15 23 23 23 23 23 23 23 23 23 24 24 24 24 24 24 24 45 26 45 45 45 24 24 24 24 24 24 24 24 24 24 24 24 24 24 24 13 14 14 14 14 14 14 14 14 14 14
14 14 15 23 23 23 23 23 23 23 23 23 24 24 23 23 23 24 24 24 23 24 24 24 24 24 24 24 24 24 24 24 23 23 23 23 23 23 24 13 14 14 14 14 14 14 14 14 14 14
14 14 15 23 23 23 23 23 23 23 23 24 24 24 23 23 23 23 24 24 23 23 23 24 24 24 24 24 24 24 24 24 24 23 23 23 23 24 24 13 14 14 14 14 14 14 14 14 14 14
14 14 15 23 23 23 23 23 23 23 23 23 24 23 23 23 23 23 24 24 24 24 23 23 23 23 23 23 23 23 23 23 24 23 23 23 24 24 24 13 14 14 14 14 14 14 14 14 14 14
14 14 15 24 23 23 23 23 23 23 23 23 23 23 24 24 23 23 23 23 23 23 23 24 24 24 24 24 24 24 24 24 24 23 24 24 24 24 10 22 14 14 14 14 14 14 14 14 14 14
14 14 15 24 24 24 24 23 23 23 24 23 23 23 23 23 24 24 24 23 24 24 24 24 24 24 24 24 24 24 24 24 24 23 23 24 24 24 13 14 14 14 14 14 14 14 14 14 14 14
14 14 15 24 24 24 23 23 23 24 23 23 23 23 23 24 24 24 24 23 23 23 23 24 24 24 24 24 24 24 24 24 24 23 23 24 24 10 22 14 14 14 14 14 14 14 14 14 14 14
14 14 15 24 24 23 23 23 23 23 23 23 23 24 24 24 24 24 24 24 24 24 23 23 23 23 23 23 23 23 23 24 24 24 23 24 24 13 14 14 14 14 14 14 14 14 14 14 14 14
14 14 15 24 24 23 23 23 23 23 23 23 24 24 24 24 24 24 24 25 25 23 23 23 23 23 23 23 23 23 23 23 23 23 23 10 11 22 14 14 14 14 14 14 14 14 14 14 14 14
14 14 15 24 24 24 24 23 23 23 24 24 24 24 24 24 24 24 24 25 25 23 23 23 23 23 23 23 23 23 23 23 23 23 23 13 14 14 14 14 14 14 14 14 14 14 14 14 14 14
14 14 15 24 24 24 24 24 23 23 24 24 24 24 24 24 24 24 23 25 25 23 23 23 23 23 23 23 23 23 23 23 23 23 23 13 14 14 14 14 14 14 14 14 14 14 14 14 14 14
14 14 15 24 24 24 24 24 24 23 23 24 24 24 24 24 24 24 23 25 25 23 23 23 23 23 23 23 23 23 23 10 11 11 11 22 14 14 14 14 14 14 14 14 14 14 14 14 14 14
14 14 21 11 11 11 12 24 24 24 23 23 24 24 24 24 24 24 23 25 25 23 23 23 23 23 23 23 23 23 10 22 14 14 14 14 14 14 14 14 14 14 14 14 14 14 14 14 14 14
14 14 14 14 14 14 15 24 23 23 23 23 23 24 24 24 24 23 25 25 23 23 23 23 23 23 23 23 23 10 22 14 14 14 14 14 14 14 14 14 14 14 14 14 14 14 14 14 14 14
14 14 14 14 14 14 15 24 24 24 24 24 23 24 24 24 24 25 25 23 23 23 23 23 23 23 23 23 10 22 14 14 14 14 14 14 14 14 14 14 14 14 14 14 14 14 14 14 14 14
14 14 14 14 14 14 21 12 24 24 24 24 23 24 24 24 24 25 25 23 23 23 23 23 23 23 23 10 22 14 14 14 14 14 14 14 14 14 14 14 14 14 14 14 14 14 14 14 14 14
14 14 14 14 14 14 14 21 11 12 24 24 23 23 24 24 25 25 23 23 23 23 23 23 23 23 23 13 14 14 14 14 14 14 14 14 14 14 14 14 14 14 14 14 14 14 14 14 14 14
14 14 14 14 14 14 14 14 14 15 24 23 23 23 23 24 25 25 23 23 23 23 23 23 23 23 23 13 14 14 14 14 14 14 14 14 14 14 14 14 14 14 14 14 14 14 14 14 14 14
14 14 14 14 14 14 14 14 14 15 24 23 23 23 23 23 25 25 23 23 23 23 23 23 23 23 23 13 14 14 14 14 14 14 14 14 14 14 14 14 14 14 14 14 14 14 14 14 14 14
14 14 14 14 14 14 14 14 14 15 24 24 24 24 24 24 25 25 23 23 23 23 23 10 11 11 11 22 14 14 14 14 14 14 14 14 14 14 14 14 14 14 14 14 14 14 14 14 14 14
14 14 14 14 14 14 14 14 14 21 11 11 11 11 11 12 25 25 23 23 23 23 10 22 14 14 14 14 14 14 14 14 14 14 14 14 14 14 14 14 14 14 14 14 14 14 14 14 14 14
14 14 14 14 14 14 14 14 14 14 14 14 14 14 14 15 25 25 23 23 23 10 22 14 14 14 14 14 14 14 14 14 14 14 14 14 14 14 14 14 14 14 14 14 14 14 14 14 14 14
14 14 14 14 14 14 14 14 14 14 14 14 14 14 14 15 25 25 23 23 10 22 14 14 14 14 14 14 14 14 14 14 14 14 14 14 14 14 14 14 14 14 14 14 14 14 14 14 14 14
14 14 14 14 14 14 14 14 14 14 14 14 14 14 14 15 25 25 23 10 22 14 14 14 14 14 14 14 14 14 14 14 14 14 14 14 14 14 14 14 14 14 14 14 14 14 14 14 14 14
14 14 14 14 14 14 14 14 14 14 14 14 14 14 14 15 25 25 10 22 14 14 14 14 14 14 14 14 14 14 14 14 14 14 14 14 14 14 14 14 14 14 14 14 14 14 14 14 14 14
14 14 14 14 14 14 14 14 14 14 14 14 14 14 14 15 25 25 13 14 14 14 14 14 14 14 14 14 14 14 14 14 14 14 14 14 14 14 14 14 14 14 14 14 14 14 14 14 14 14
14 14 14 14 14 14 14 14 14 14 14 14 14 14 14 15 25 25 13 14 14 14 14 14 14 14 14 14 14 14 14 14 14 14 14 14 14 14 14 14 14 14 14 14 14 14 14 14 14 14
14 14 14 14 14 14 14 14 14 14 14 14 14 14 14 15 25 25 13 14 14 14 14 14 14 14 14 14 14 14 14 14 14 14 14 14 14 14 14 14 14 14 14 14 14 14 14 14 14 14
14 14 14 14 14 14 14 14 14 14 14 14 14 14 14 21 11 11 22 14 14 14 14 14 14 14 14 14 14 14 14 14 14 14 14 14 14 14 14 14 14 14 14 14 14 14 14 14 14 14
14 14 14 14 14 14 14 14 14 14 14 14 14 14 14 14 14 14 14 14 14 14 14 14 14 14 14 14 14 14 14 14 14 14 14 14 14 14 14 14 14 14 14 14 14 14 14 14 14 14
14 14 14 14 14 14 14 14 14 14 14 14 14 14 14 14 14 14 14 14 14 14 14 14 14 14 14 14 14 14 14 14 14 14 14 14 14 14 14 14 14 14 14 14 14 14 14 14 14 14
14 14 14 14 14 14 14 14 14 14 14 14 14 14 14 14 14 14 14 14 14 14 14 14 14 14 14 14 14 14 14 14 14 14 14 14 14 14 14 14 14 14 14 14 14 14 14 14 14 14
14 14 14 14 14 14 14 14 14 14 14 14 14 14 14 14 14 14 14 14 14 14 14 14 14 14 14 14 14 14 14 14 14 14 14 14 14 14 14 14 14 14 14 14 14 14 14 14 14 14
14 14 14 14 14 14 14 14 14 14 14 14 14 14 14 14 14 14 14 14 14 14 14 14 14 14 14 14 14 14 14 14 14 14 14 14 14 14 14 14 14 14 14 14 14 14 14 14 14 14
14 14 14 14 14 14 14 14 14 14 14 14 14 14 14 14 14 14 14 14 14 14 14 14 14 14 14 14 14 14 14 14 14 14 14 14 14 14 14 14 14 14 14 14 14 14 14 14 14 14
14 14 14 14 14 14 14 14 14 14 14 14 14 14 14 14 14 14 14 14 14 14 14 14 14 14 14 14 14 14 14 14 14 14 14 14 14 14 14 14 14 14 14 14 14 14 14 14 14 14
14 14 14 14 14 14 14 14 14 14 14 14 14 14 14 14 14 14 14 14 14 14 14 14 14 14 14 14 14 14 14 14 14 14 14 14 14 14 14 14 14 14 14 14 14 14 14 14 14 14
14 14 14 14 14 14 14 14 14 14 14 14 14 14 14 14 14 14 14 14 14 14 14 14 14 14 14 14 14 14 14 14 14 14 14 14 14 14 14 14 14 14 14 14 14 14 14 14 14 14
14 14 14 14 14 14 14 14 14 14 14 14 14 14 14 14 14 14 14 14 14 14 14 14 14 14 14 14 14 14 14 14 14 14 14 14 14 14 14 14 14 14 14 14 14 14 14 14 14 14
14 14 14 14 14 14 14 14 14 14 14 14 14 14 14 14 14 14 14 14 14 14 14 14 14 14 14 14 14 14 14 14 14 14 14 14 14 14 14 14 14 14 14 14 14 14 14 14 14 14
14 14 14 14 14 14 14 14 14 14 14 14 14 14 14 14 14 14 14 14 14 14 14 14 14 14 14 14 14 14 14 14 14 14 14 14 14 14 14 14 14 14 14 14 14 14 14 14 14 14
14 14 14 14 14 14 14 14 14 14 14 14 14 14 14 14 14 14 14 14 14 14 14 14 14 14 14 14 14 14 14 14 14 14 14 14 14 14 14 14 14 14 14 14 14 14 14 14 14 14
14 14 14 14 14 14 14 14 14 14 14 14 14 14 14 14 14 14 14 14 14 14 14 14 14 14 14 14 14 14 14 14 14 14 14 14 14 14 14 14 14 14 14 14 14 14 14 14 14 14
14 14 14 14 14 14 14 14 14 14 14 14 14 14 14 14 14 14 14 14 14 14 14 14 14 14 14 14 14 14 14 14 14 14 14 14 14 14 14 14 14 14 14 14 14 14 14 14 14 14
14 14 14 14 14 14 14 14 14 14 14 14 14 14 14 14 14 14 14 14 14 14 14 14 14 14 14 14 14 14 14 14 14 14 14 14 14 14 14 14 14 14 14 14 14 14 14 14 14 14
